~~~~~~~~~~~~~
~....=...=..~
~=======.===~
~..=...=.=..~
~..=....==..~
~..=..==.=..~
~~~~~~~~~~~~~
