~~~~~~~~~~~~~
~....=...=..~
~.==.=======~
~....=.=.=..~
~=.===.=.=..~
~=.=..====..~
~~~~~~~~~~~~~
