~~~~~~~~~~~~~
~....=...=..~
~===========~
~..=...=.=..~
~..=...=.=..~
~..=..====..~
~~~~~~~~~~~~~
