~~~~~~~~~~~~~
~.....=..=..~
~.===.======~
~.===.==.=..~
~.....==.=..~
~=========..~
~~~~~~~~~~~~~
